~~~~~~~~~~~~~~~~~~~~~~~~~~~~~~~~~
~~~~~~~~~~~~~~~~~~~~~..~~~...~~~~
~~~~~~.T~~~~~~~...~~~~.~~.T^.~~~~
~~~~~.^.~~~~~~..T..~~~~~~.TT.~~~~
~~~~~~.....~~~~.TT..~~~~~~..~~~~~
~~~~~.............^^..~~~~~~~~~~~
~~~~~....TTT....^^^......~~~~..~~
~~~~~~....TTTT^^^^.....~~~~~.~~~~
~~~~~~~...TTT^^^^TTTT........~~~~
~~~~~....TTTTTTTTT..T......~~~~~~
~~~~~....^^^~~..TT.T...~~~~~~~~~~
~~~~~~~..^.~~~~..TTT..~~~~~~~~~~~
~~~~~~~~~~~~~~~~~~~~~~~~~~~~~~~~~